##############################
#                  c#       #
#                  #         #
#                  #         #
#            c#dh##3         #
#            #     #         #
#            #     #         #
#          D#3     2#p       #
#            #     #         #
#            #     #         #
#            C#dh##3         #
#                  #         #
#                  #         #
#                  C#p       #
##############################
