##################
#      c#p       #
#      #         #
#      #         #
#  dh##3         #
#      #         #
#      #         #
#  dh##3         #
#      #         #
#      #         #
#      C#p       #
#                #
#                #
#                #
#                #
#                #
#                #
#                #
##################
