##################
#                #
#   ##########   #
#   D        H   #
#   ##########   #
#                #
#                #
##################
