##################
#                #
#       H        #
#      B         #
#  DT  b         #
#                #
#       H        #
##################
